5 10
|========|
|...|..=.|
|..=|.@..|
|......=.|
|========|